red:0,A
+++++++++
+       +
+  +++  +
+  + +  +
+  +++  +
+0  A  a+
+++++++++
